00000000000000000000000000000000000000000000000000000000000000000
00000000000000000000000000000000000000000000055555555555555555555
00000000000000000000000000000000000000000000555555555555555555555
00000000000000000000000000000000000000000005555555555555555555555
00000000000000000000002000000000000000000055555555555555555555555
00000000000000000000000000000000000000000555555555555555555555555
00000000000000000000000000000000000000005555555555555555555555555
00000000000000000000000000000000000000055555555555555555555555555
00000000000000002000121210000000000000555555555555555555555555555
00000000000000000000000000000000000005555555555555555555555555555
00000000000000000000000000003000000055555555555555555555555555555
00006000000070000000000000004000000555555555555555555555555555555
555555555555555555555555555555555555555555555555555555555555555555555555555555555555555555555555555555555555555555555555555555555555555555555555555555555555
555555555555555555555555555555555555555555555555555555555555555555555555555555555555555555555555555555555555555555555555555555555555555555555555555555555555